NO ./textures/north.xpm
F        255,255,255




F        255,255,255


SO ./textures/south.xpm
EA   ./textures/west.xpm
C       70,70,70




C       70,70,70



WE            ./textures/east.xpm



  1111
110001
1000N1
111111
